11111111111111111111111111111111111
1000C000000000000000000001000000001
11011110001C0111111111100111110C111
1001C00011110010010C000100000010001
1011111110001111010C000111111011001
1011E000100000000000C10110001000001
1P01001001GGGGGG100010000010C011011
11111111000111111111111111111111111
11111111111111111111111111111111111
