1111111111111111111111111111111111
1000C00010001000000001000100000001
11011110001C111111011101111110C111
1001C00011110010010C00010000001001
1011111110001111010C00000100101101
1011E00100000010000C11111001000001
1P01001001000000100010000011C01101
1111111111111111111111111111111111
