1111111111111111111111111111111111111111
1P088C000T00C008VV1@1880T0068C0C81@50101
1@1233341|01*1>080C0C8C0|0<1E0C0C60T08<1
1*>08050@|011GGG12341118|0111111115|80<1
11>00CT80|0001111088T0V8|0U81120411|0501
1C0115|8808800800C8C|110|0D0*080080|0081
1**180|00^1@1111>000|000111108C111GGGGG1
1*C8011C111*1@@11GGGGGGG1**1C051@1111@11
1111111111111111111111111111111111111111
