111111111111111111111111111111111111111
1P000C000T00C000VV111000T060C0C01110101
111233341|0111>000C0C0C0|<1C0C0C60T08<1
11>080001|011GGG12341110|111111114|00<1
11>00C000|0001111000T0V00U01100411|0501
1C011500008800000C0C|1100D01000080|0001
111100000W01111LLLLLLLLL11200C001GGGGG1
11С00110111LLLLLL1111111LL1C05111111111
111111111111111111111111111111111111111