1111111111111111111111111111111111111111
1P088C000T..C008VV11188.T0068C0C81110101
111233341|.111>080C0C8C.|0<1E0C0C60T08<1
11>08.501|011GGG12341118|0111111115|80<1
11>..CT80|0001111.88T0V8|0U81120411|0501
1C0115|88088008..C8C|110|0D0108..80|0081
111180|00^11111lllllllll111108C8.1GGGGG1
11C80110111LLLLLL1111111LLL1C05111111111
1111111111111111111111111111111111111111
