1111111111111111111111111111111111111111
1P088C000T00C008VV1@1880T006800C81@50#01
1@1233341|41*1>080C0C8C0|0<1E0C0C00T08<1
1*>08050@|0#1GGG12341118|0111111115|80<1
11>000T80|00#1111088T0V8|0U81120411|0501
1000@5|8808800800C8C|#10|000TT|0080|0081
1**@80|00^1@1111>000|00|1111||C111GGGGG1
1*08011L111*1@@11GGGGGGG1**1||51@1111@11
1111111111111111111111111111111111111111
