11111111111
1P088000001
11111110001
100U800C001
188M8H00001
180D0D000E1
11111111111
