11111111111111111
1P0#1V088ET0C0C<1
15888C0C88|@234@1
18#@2341>0|U88^01
100U800#>0|M01101
188M8H0880|M80#01
180D0DC000|1GGGG1
11111111111111111
